111111111111111111111111-
100000000001100000000001-
101000000101101000000101-
100000000001100000000001-
100000000001100000000001-
100000000000000000000001-
100000000000000000000001-
100000000001100000000001-
100000000001100000000001-
101000000101101000000101-
100000000000000000000001-
111110011100001110011111-
111110011100001110011111-
100000000000000000000001-
101000000101101000000101-
100000000001100000000001-
100000000001100000000001-
100000000000000000000001-
100000000000000000000001-
100000000001100000000001-
100000000001100000000001-
101000000101101000000101-
100000000001100000000001-
111111111111111111111111