11111111111111111111111-
10000000000100000000001-
10111011110101111011101-
10111011110101111011101-
10000000000000000000001-
10111010111111101011101-
10000010000100001000001-
11111011110101111011111-
00001010000000001010000-
11111010111011101011111-
10000000100000100000001-
11111010111111101011111-
00001010000000001010000-
11111010111111101011111-
10000000000100000000001-
10111011110101111011101-
10001000000000000010001-
11101010111111101010111-
10000010000100001000001-
10111111110101111111101-
10000000000000000000001-
11111111111111111111111